10
5000
500
2
10
10
10
WWWWWWWWWWWWWWWWWWW
W-------R----O----W
WWOW-W-W-W-W-W-W-WW
W-O--------R------W
WWOWOW-W-W-W-WOW-WW
W--O--------O-R---W
WWOW-W-W-W-W-W-W-WW
W-OOOO---1-------OW
WWOWOWOWOW-W-W-W-WW
W--OOOO--R--OOO---W
WW-W-WOWOW-WOWOWOWW
W------OOO--OOO-ORW
WWWWWWWWWWWWWWWWWWW