120
2000
2000
4
500
10
100
WWWWWWWWWWWWWWWWWWW
W-2-----R----O----W
WWOW-W-W-W-W-W-W-WW
W-O--------R------W
WWOWOW-W-W-W-WOW-WW
W--O--------O-R--3W
WWOW-W-W-W-W-W-W-WW
W-OOOO---1-------OW
WWOWOWOWOW-W-W-W-WW
W--OOOO--R--OOO---W
WW-W-WOWOW-WOWOWOWW
W------OOO--OOO-ORW
WWWWWWWWWWWWWWWWWWW